G1	G2	G3	G4	G4	G3	G2	G1
G2	G3	G4	G5	G5	G4	G3	G2
G3	G4	G5	G6	G6	G5	G4	G3
G3	G4	G5	G6	G6	G5	G4	G3
G2	G3	G4	G5	G5	G4	G3	G2
G1	G2	G3	G4	G4	G3	G2	G1
