G7	G7	G7	G7	G7	G7	G7	G7
G7	G0	G0	G4	G4	G0	G0	G7
G7	G0	G4	G4	G4	G4	G0	G7
G7	G4	G4	G4	G4	G4	G4	G7
G7	G0	G0	G4	G4	G0	G0	G7
RR	RR	RR	G4	G4	RR	RR	RR
