G5	G5	G5	G5	G5	G5	G7	G5
G5	G5	RR	G5	G5	G7	G7	G7
G5	RR	RR	RR	G7	G7	G7	G7
RR	RR	RR	RR	RR	G7	G7	G7
RR	RR	RR	RR	RR	RR	G7	G7
RR	RR	RR	RR	RR	RR	RR	RR
