G6	G6	SS	SS	SS	SS	SS	G6
G6	SS	G6	G6	G6	G6	G6	G6
G6	G6	SS	SS	G6	G6	G6	G6
G6	G6	G6	G6	SS	SS	G6	G6
G6	G6	G6	G6	G6	G6	SS	G6
G6	SS	SS	SS	SS	SS	G6	G6
