G3	G3	G3	G3	G3	G3	G3	G3	G2	G2	G2	G3
G3	G3	G3	G3	G3	G2	G2	G2	G3	G3	G3	G3
G3	G3	G3	G3	G3	G3	G3	G3	G3	G3	G3	G3
G3	G1	G1	G3	G3	G3	G3	G3	G3	G2	G2	G2
G1	G1	G3	G1	G3	G2	G2	G2	G2	G3	G3	G3
G1	G1	G1	G1	G3	G3	G3	G3	G3	G3	G3	G3
G1	G1	G1	G1	G3	G3	G3	G3	G3	G3	G2	G2
G1	G1	G1	G1	G3	G2	G2	G2	G2	G2	G3	G3
G3	G1	G1	G3	G3	G3	G3	G3	G3	G3	G3	G3
