G5	G5	G5	G5	G5	G5	G5	G3	G3	G5	G5	G5
G5	G5	G5	G5	G5	G3	G5	G3	G3	G5	G3	G5
G5	G5	G5	G0	G0	G5	G3	G3	G3	G3	G5	G5
G5	G5	G0	G0	G0	G0	G3	G3	G3	G3	G5	G3
G5	G5	G0	G7	G7	G0	G0	G3	G3	G3	G5	G5
G5	G0	G0	G7	G7	G7	G0	G0	G3	G0	G3	G5
G0	G0	G7	G7	G7	G7	G7	G0	G0	G0	G0	G5
G0	G7	G7	G7	G7	G7	G7	G7	G7	G7	G0	G0
G5	G5	G5	G5	G5	G5	G5	G5	G5	G5	G5	G5
