G0	G0	G0	G0	G0	G0	G0	G0	G0	G0	G0	G0
G0	HH	HH	RR	RR	RR	G2	G2	G2	RR	RR	RR
HH	G0	G0	G0	RR	G0	G2	SS	G2	RR	G0	RR
HH	G0	G0	G0	RR	G0	G2	SS	G2	RR	G0	RR
HH	HH	HH	G0	RR	G0	G2	SS	G2	RR	RR	RR
G0	G0	HH	G0	RR	G0	G2	SS	G2	RR	G0	G0
G0	G0	HH	G0	RR	G0	G2	SS	G2	RR	G0	G0
HH	HH	G0	G0	RR	G0	G2	G2	G2	RR	G0	G0
G0	G0	G0	G0	G0	G0	G0	G0	G0	G0	G0	G0
