G7	G4	G7	G7	G7	G7	G7	G4	G7	G7	G4	G7
G4	G7	G7	G7	G4	G4	G7	G4	G7	G7	G7	G4
G4	G7	G4	G7	G7	G4	G7	G7	G4	G7	G7	G4
G4	G7	G7	G7	G4	G4	G7	G7	G4	G7	G7	G4
G4	G7	G7	G7	G4	G4	G7	G4	G7	G7	G7	G4
G4	G7	G4	G7	G7	G4	G7	G7	G7	G4	G7	G4
G4	G7	G7	G7	G4	G4	G7	G7	G4	G7	G7	G4
G7	G4	G7	G7	G7	G7	G7	G4	G4	G4	G4	G7
RR	RR	RR	RR	RR	RR	RR	RR	RR	RR	RR	RR
